a a a! :: Hahaha! (laughter)
a a a! ni li musi :: Hahaha! That's funny
a a a! sina nasa :: Hahaha! You're crazy
a! akesi li wile moku e mi! :: Ahh! The dinosaur wants to eat me!
a :: [interj] ahh, ha!, umm, hmm, ooh, well, wow, ah! aw! (emotion word)
akesi linja ko ma :: worm
akesi linja :: snake, rope-like reptiles
akesi li pana e telo moli :: The snake emitted venom ("deadly fluid")
akesi :: [n] non-cute animal, reptile, amphibian, dinosaur, monster
akesi pi telo moli :: venomous snakes, poisonous frogs 
ala li jaki :: Nothing is dirty
ala :: [mod] no, not, none, un-  [n] nothing; a state of nothingness, negation, zero  [interj] no! 
alasa :: [v]to hunt; to gather food, resources or material; to harvest; to search; to look for
ale li jo e tenpo :: There is a time for everything; everything in its right context
ale li pona :: All is good; life is beautiful; everything will be OK; I'm in peace; I feel calm
ali (ale) :: [n]everything, all, anything, life, the universe  [mod] all, every, complete, whole ("ale" has been deprecated for phonetic reasons; "ali" is the most common word in use)
a. mi sona :: Oh, I understand
anpa lawa :: throat, neck (bottom of head) 
anpa :: [n] ground, bottom, floor, under, beneath  [mod] low, deep, defeated  [v] to lower, to defeat, to challenge, to overcome
anpa pi sinpin lawa :: chin 
ante la :: on the other hand, otherwise
ante li kama :: Change comes; times change
ante :: [n] difference  [mod] different, other  [cont] otherwise, or else  
anu :: [conj] or
apeja :: [unofficial] disgrace, shameful. (apeja ala = honor)
a! sina jo e noka suli! :: Oh! You have big feet!
a! sina lukin ala lukin e ijo nasa ni? :: Whoa! Do you see that weird thing? 
a! telo sijelo loje li kama tan nena kute mi!  :: Ahh! Blood is coming from my ear! 
awen e jaki :: to clean
awen pona :: patient
awen sona :: remember, keep in mind
awen :: [v] to stay, pause, wait, remain, keep  [mod] remaining, stationary, permanent, sedentary, protect
en :: [conj] and (used to coordinate head nouns)
e :: [sep] (introduces a direct object)
esun kala :: fish market
esun kili :: fruit, vegetable market
esun mani :: stock market
esun :: [n] market, shop, trading place, bazaar, store, social gathering, fair
ijo ike li lon monsi mi :: Bad things are behind me
ijo li lon oko mi :: Something is in my eye
ijo li lukin e mi :: Something is watching me
ijo lon tomo :: household things 
ijo nasa pi kasi lipu nasa :: weed (drugs)
ijo ni li wile e mani lili :: This thing is cheap
ijo :: [n] thing, something, stuff, anything, object  [mod] of something  [v] objectify
ijo uta walo :: teeth 
ike la :: badly, unfortunately
ike li kama :: Bad comes; shit happens   
ike lukin :: ugly 
ike :: [mod] bad, evil, wrong, evil, overly complex, (figuratively) unhealthy  [interj] oh dear! woe! alas!  [n] negativity, evil, badness  
ike! :: Oh no!, Uh oh!, Alas! 
I like plants :: kasi li pona tawa mi 
ilo kipisi :: knife
ilo kute :: headphones
ilo lape :: sleeping pill 
ilo lape soweli :: animal tranquilizer or anesthetic, such as ketamine 
ilo li lon poki :: The tools are in the container
ilo li pakala :: The tool is broken
ilo lukin lili :: microscope
ilo lukin weka :: telescope
ilo moku :: eating utensil (fork/spoon/knife)
ilo musi :: toy, thing used for entertainment
ilo nanpa :: computer 
ilo nanpa lili :: calculator
ilo nanpa tawa :: laptop (see "ilo nanpa")
ilo nasa :: drugs 
ilo nasa wawa :: energy-giving drug, such as amphetamine 
ilo ni li pilin lete :: This axe feels cold
ilo :: [n] tool, device, machine, thing used for a specific purpose
ilo oko pi suno :: sunglasses
ilo oko :: spectacles, binocle, microscope, telescope, glasses (see "ilo lukin")
ilo pi kule mun pi seli moli :: ash
ilo pi sitelen tawa :: television, TV
ilo pi sitelen toki :: pen, pencil 
ilo sitelen :: tool used for writing or creating images; camera; pencil; an artist's paint
ilo sona :: smart tool or machine, such as a computer (see "ilo nanpa")
ilo suno :: a tool of light, lamp, flashlight  
ilo tawa pi telo loje pi sijelo insa :: heart
ilo tenpo :: clock, watch, time machine
ilo toki :: communications device, such as a telephone, online chat 
ilo unpa :: sex toy 
ilo wan ma :: Internet 
ilo wawa li lon ma ni :: Somewhere on this island is a power source
Inli :: England, English 
insa :: [n] inside, inner world, centre, stomach  [mod] internal, central 
Intonesija :: Indonesia, Indonesian 
Isale :: Israel
Isilan :: Iceland, Icelandic 
Italija :: Italy, Italian
jaki ala :: clean, not dirty
jaki :: [mod] dirty, nasty, gross, filthy  [n] dirt, trash, pollution, filth  [v] pollute
Jamanija :: Yemen
jan ala li toki :: Nobody is talking
jan alasa :: harvester, hunter, gatherer, seeker
jan ale li lon seme? :: Where did everyone go?
jan ali li wile tawa :: Everybody wants to travel
jan Ana o pana e moku tawa mi :: Ana, give me food
jan Epi o a! :: Oh Abbie! 
jan esun :: business person, trader
jan Eta li jan unpa :: Heather is a prostitute
jan ike :: bad person, jerk, negative person, enemy 
jan ike li kama la o seli e lipu ni :: If the enemy comes, burn these papers
jan ike li utala e ona mute :: An enemy is attacking them
jan ike lon anpa :: Bad people live defeated
jan ike ni li jo e len nasa :: That bad person has strange clothes
jan ike pi telo suli :: pirate
jan kala :: mermaid
jan Kanata :: Canadian person 
jan Keli o, sina pona lukin :: Kelly, you are pretty 
jan Ken o, mi olin e sina :: Ken, I love you 
jan Ken o, pipi li lon len sina :: Ken, a bug is on your shirt 
jan kulupu :: member of a group
jan laso jelo lili li kama tan sewi :: A little green person came from the sky
jan lawa :: leader, boss, master, chairperson, president, director 
jan lawa li moku e telo jaki :: The leader drank dirty water
jan lawa ma :: president of country, governor of state, premier of province 
jan lawa pi jan utala :: leader of soldiers (commander, general) 
jan lawa pi ma tomo :: mayor 
jan lawa pi tomo tawa kon :: leader of airplanes, a pilot 
jan lawa pi tomo tawa telo li moku :: The captain of the ship is eating
jan li ken kama tawa pini kepeken nasin pona! :: Some winners are bigger than other winners!
jan lili :: child, daughter, son  
jan lili en jan suli li toki :: The child and the adult are talking 
jan lili li ken ala moku e telo nasa :: Children can't drink beer
jan lili li lukin e jan suli :: Children watch adults
jan lili li sona ala e ike :: Children are innocent
jan lili li wile e telo kili :: Children want fruit juice 
jan lili pi jan Keli li musi :: Keli's child is funny
jan lili pi jan Ken en jan Lisa li suwi :: Ken and Lisa's baby is sweet
jan lili sina li suwi :: Your baby is cute
jan lili :: small, short, thin or young person, child 
jan lili tu wan :: 3 children 
jan li lon insa tomo :: Somebody's inside the house
jan li lukin sama pipi :: People look like ants
jan li moku :: Somebody is eating
jan li moli e waso :: The person killed the bird 
jan li moli :: People are murderers
jan li pona :: People are good
jan Lisa li pona :: Lisa is cool
jan Lisa o, toki :: Hello, Lisa
jan Lisa taso li kama :: Only Lisa came 
jan li seme? :: People are what? Who are they?
jan li suli mute. mani li suli lili :: People are more important than money
jan li toki kepeken toki pona lon tomo toki :: People talk using Toki Pona in the chat room
jan li wile jo e ma :: People want to own land 
jan luka tu :: 7 people
jan Mawen o, sina wile ala wile moku? :: Marvin, are you hungry? 
jan Mesiko :: Mexican person 
jan Mewi li toki tawa mi :: Mary's talking to me
jan moli :: dead man, zombie
jan Mose o lawa e mi mute tawa ma pona :: Moses, lead us to the good land
jan mute li kama :: Many people are coming
jan mute lili li kama :: Some people are coming
jan mute mute mute li kama! :: Many, many, many people are coming! 
jan namako :: extras in a movie, people acting as decoration or performing
jan nasa :: strange, foolish, unconventional or crazy person, drunk person, alcoholic
jan nasa utala :: fighting fool
jan Nesan li musi :: Nathan is funny 
jan ni li pona lukin :: That person is pretty 
jan ni li sama mi :: That person is like me
jan :: [n] person, people, human, being, somebody, anybody, in  [mod] personal, human, somebody's, of people  [v] personify, humanize, personalize 
jan olin :: loved one, significant other, partner
jan pakala :: disabled person, an injured person, victim
jan pali li pona e supa jaki :: The servants cleaned the carpet
jan pali :: worker, employee
jan Pawe o, mi wile ala moli :: Forrest, I don't want to die
jan Pentan li pana e sona tawa mi :: Brandon teaches me
jan pi ike lukin :: an ugly person 
jan pi jan unpa mute :: promiscuous person
jan pi kama sona :: student
jan pi ma ante :: foreigner, immigrant
jan pi ma sama :: fellow citizen of same country or land 
jan pi ma tomo :: person of the city, a city-dweller 
jan pi musi sijelo :: athlete 
jan pi nanpa tu tu :: 4th person 
jan pi nanpa wan li lon :: The first person is here
jan pi nasin sewi Kolisu :: person of Christian religion, a Christian 
jan (pi pali) moku :: chef, cook 
jan (pi pali) unpa :: sex worker, prostitute, whore, bitch
jan pi pana sona :: teacher
jan pi pona lukin :: an attractive person
jan pi pona pilin :: psychotherapist
jan pi pona sijelo :: doctor, healer 
jan pi sona oko :: oculist, eye doctor, optometrist
jan pi tomo pali :: office worker
jan pi tomo sama :: housemate, roommate 
jan pi wawa ala :: a weak person 
jan poka :: neighbor, someone who is beside you 
jan pona :: good person, friend, positive or good person
jan pona mi li lon poka mi :: My friend is beside me
jan sama :: similar person, counterpart, peer, person in same situation, sibling, brother, sister
jan San li seme? :: Who is John? 
jan San o, :: John, 
jan San o tawa tomo sina!  :: John, go to your house! 
jan Santa :: Santa Claus 
jan seme li jo e poka mi pi kalama musi? :: Who has my mp3 player? (container of music)
jan seme li lon ni? :: Who is there?  
jan seme li lon? :: Who's there?
jan seme li meli sina?  :: Who is your female partner? 
jan seme li moku? :: Who is eating? 
jan seme li olin e sina? :: Who loves you?  
jan seme li tawa poka sina? :: Who went with you? 
jan seme pi kulupu ni li suli? :: Which people of this group are important?  
jan Sesi o moku e kili ni :: Jessie, eat this fruit
jan sewi :: God; Divinity; any sentient, real or non-extant, considered divine
jan sin li kama ala kama? :: Are more people coming?  
jan sin li kama :: More people are coming
jan sona :: knowledgeable person, wise person, educated person, academic, specialist 
jan sona li jan nasa :: A wise man is a fool; a genius thinks unconventionally
jan sona nanpa :: mathematician 
jan sona pilin :: psychologist 
jan sona sijelo :: doctor, physician 
jan suli :: big, tall or fat person, adult 
jan Susan anu jan Lisa li moku e suwi? :: Susan or Lisa ate the cookies? 
jan Susan li nasa :: Susan is crazy
jan Ta o toki ala tawa mi :: Todd, don't talk to me 
jan Tepani o, sina ike tawa mi :: Steffany, I don't like you 
jan toki :: speaker, messenger, person communicating, spokesman
jan unpa :: lover, sexual partner, nymphomaniac
jan utala ali li nasa :: All soldiers are stupid
jan utala li seli ala seli e tomo?  :: Is the warrior burning the house? 
jan utala nasa mute :: many stupid soldiers  
jan utala nasa ni :: this stupid soldier  
jan utala nasa :: stupid soldier
jan utala pi ma Mewika li ike tawa ma ali :: Soldiers of the USA are bad for the world
jan utala :: soldier, warrior, assassin
jan Wasintan li jan lawa pona pi ma Mewika :: Washington was a good leader of America 
jan wawa :: strong person 
jelo :: [mod] yellow, light green
jo ala e selo lon pini palisa :: to be circumsized
jo e linja mute :: to be hairy 
jo e mani mute :: to be rich 
jo e pilin pona :: to have positive feelings, be mentally healthy 
jo e selo lon pini palisa :: uncircumcised, uncut 
jo e sijelo pona :: to be (physically) healthy 
jo ijo li ike e jan :: Possession corrupts
jo :: [v] to have, contain  [n] ownership, posession, having
kala :: fish or an animal that lives in the water, seafood
kala kalama :: noisy fish, any variety of noisy fish, the category of fish that makes audible noises, such as the dog fish
kala kiwen kepeken insa moku :: edible mollusk
kala kiwen loje :: crab or lobster
kala kiwen :: mollusks, lobsters, barnacles and other sea creatures with exoskeletons
kala kiwen pimeja :: mussel
kala kulupu jan :: pescine community of people, such as a fishing village or fisherman's trade union
kala kulupu :: pescine community
kala len :: fish of clothing, such as fish suitable for making Icelandic folk fish-skin shoes
kala lete :: raw fish, sushi 
kala lili :: small fish, or any variety of small fish, or the category of small fish, such as the minnow
kala loje pi linja telo - Salmon; other red fish which inhabit rivers
kalama ala li lon :: No sound exists; silence
kala ma :: lung fish, other fish that can live out of water
kalama musi en meli li pona tawa mi :: I like music and girls 
kalama musi "Jingle Bells" li pona tawa mi :: I like the song "Jingle Bells"
kalama musi li pona tawa mi :: I like music 
kalama musi pi jan Elton-John li nasa :: The music of Elton John is odd 
kalama musi pi jan Enja li pona :: Enya's music is good
kala mani :: fish hunted for commercially
kalama ni li seme? :: What was that noise? 
kalama :: [n] sound, voice, noise  [v] to make noise or sound, to ring, to play an instrument
kala moli :: poisonous fish
kala :: [n] fish, sea creature 
kala sama :: camouflaged fish
kala seli :: tropical fish
kala selo :: shell fish
kala suli :: big fish, whale, shark
kala suli pi mama soweli moli :: killer whale (lit: big fish of the killer maternal cute animals)
kala suli pi mama soweli :: whale (lit: big fish of the maternal cute animals)
kama anpa :: go down, descend
kama ante :: transform, turn into, to change
kama e :: bring, fetch, carry, becomes, converts
kama insa :: come into, enter
kama jaki ala :: to clean up
kama jo e lupa meli :: to get genital reconstruction surgery as a women, such as vaginoplasty  
kama jo e palisa mije :: to get genital reconstruction surgery as a man, such as metoidioplasty, phalloplasty 
kama jo e sinpin lawa meli :: to get facial feminization surgery 
kama jo e sinpin mije :: to get male chest reconstruction surgery 
kama jo e telo :: to get water
kama jo :: get, receive, take, obtain
kama jo lon esun :: to get at the market, pickup, buy
kama jo :: receive, get, take, obtain
kama lili :: diminish, decrease
kama li pona tawa mi :: I'm a lucky guy
kama :: [n] event, happening, chance, arrival, beginning  [mod] coming, future  [v] come, become, arrive, happen, pursue actions to arrive to (a certain state), cause
kama olin :: fall in love with 
kama pilin ike :: get angry
kama pi lukin ala :: to hide
kama pi lukin sin :: to find
kama pona! :: Come well! Welcome! Greetings!
kama sewi :: go up, ascend
kama sewi sin :: revive, resurrect
kama sinpin :: stand up
kama sin :: rebirth, come back, return
kama sona tan kepeken :: learning by doing
kama telo :: melt
kama wan :: unite, meet
kasi anpa :: grass 
kasi kule :: flower 
kasi kule li pona lukin :: Flowers are pretty
kasi lili :: little weeds 
kasi linja laso jelo :: grass
kasi nasa / kasi sona :: weed, hemp, intoxicating plant, such as marijuana 
kasi :: [n] plant, leaf, herb, tree, wood 
kasi pi tenpo pona Kolisu :: Chrismas tree 
kasi pona lukin li lon :: It's a very pretty flower
kasi suli pi nanpa mute :: forest
kasi suli :: trees, big shrubs 
kasi wawa :: spice 
ken la ilo li pakala :: Maybe the tool is broken
ken la jan lili li wile moku e telo :: Maybe the baby is thirsty
ken la jan Lisa li jo e ona :: Maybe Lisa has it
ken la jan Susan li kama :: Maybe Susan will come
ken la :: maybe
ken la mi ken tawa ma Elopa :: Maybe I can go to Europe
ken la mi sona mute! :: Maybe I know a lot!
ken la ona li lape :: Maybe he's alseep
ken la ona li lon tomo sona :: Maybe he's in school
ken :: [n] possibility, ability, power to do things,  permission  [v] can, is able to, is allowed to, may, is possible  [v]  make possible, enable, allow, permit  
kepeken e kasi nasa :: to use a non-synthetic drug
kepeken e utala :: to use violence 
kepeken ike e ilo nasa :: to abuse drugs  
kepeken lili e ilo nasa :: to use drugs in moderation 
kepeken :: [v] use  [prep] with
kili lili kiwen :: nut 
kili lili :: small vegetable, fruit, such as berry, olive 
kili li lon poki :: The fruit is in the basket 
kili li moku li pona :: Pineapple is a food and is good
kili li pona tawa mi :: I like fruit
kili li tawa anpa poka kasi :: The apple doesn't drop far from the tree
kili loje :: reddish fruit or vegetable, such as a tomato 
kili ma :: earth vegetable, such as a potato 
kili mi :: my fruit 
kili :: [n] fruit, vegetable, mushroom
kili palisa :: long fruit or vegetable, such as a carrot, banana, cucumber 
Kilipasi :: Kiribati 
kili pi jan Linta li ike :: Linda's fruit is bad
kili pi jan Susan :: Susan's fruit 
kili suwi :: (sweet) fruit      
kin :: [mod] also, too, even, indeed (emphasizes the word that follows)
kipisi tomo :: fence, wall
kipisi :: [v] to divide, to cut
kiwen jelo li wile e mani mute :: The gold is expensive
kiwen kule :: colorful metal
kiwen linka :: wire, ductile metal
kiwen mun :: moon rock
kiwen :: [n] hard thing, rock, stone, metal, mineral, clay  [mod] hard, solid, stone-like, made of stone or metal
kiwen pakala :: broken rock, gravel
kiwen pan :: day old bread
kiwen pi sitelen insa :: bone
kiwen suwi :: rock candy
kiwen telo :: lava, mercury, liquid rock
kiwen uta :: teeth
kiwen weka :: mining, to carve
kiwen wile :: desirable rocks, precious metals, gems
ko jaki lon nena sinpin :: boogers 
ko jaki :: shit, feces, pooh 
ko lete li kama :: It's snowing
kon en sewi :: weather 
kon :: [n] air, odour, soul, spirit, atmosphere, wind  [mod] air-like, ethereal, gaseous
ko :: [n] semi-solid substance, such as a paste, a powder, or a gum
kon sewi li jo e walo :: It's cloudy
kon tawa :: wind
kon telo walo :: cloud, snow, fog 
ko (walo) wawa :: cocaine 
kule laso loje li pona tawa mi :: I like the color purple
kule lon palisa luka :: nail polish
kule namako :: cosmetics, make-up, flashy colors
kule :: [n] color, paint  [v] color, paint  [mod] colourful
kule seme li pona tawa sina? :: Which color do you like?  
kule sewi :: rainbow
kulupu :: group, community, society 
kulupu kala :: community of fish
kulupu mama :: family 
kulupu musi :: a party, a fun gathering
kulupu :: [n] group, community, society, company  [mod] communal, shared, public, of the society
kulupu pi jan kala :: community of fishermen
kulupu pi tenpo mun :: Month 
kulupu pi tenpo suno luka tu :: days of the week 
kulupu pi toki pona :: the Toki Pona community 
kute tan kama sona. kute tan ala toki :: Listen to know, don't listen to speak
kute :: [v] listen, hear  [mod] auditory, hearing
lape li pona :: Sleep and rest are good
lape :: [n][v] sleep, rest  [mod] sleeping, of sleep
lape pona! :: Sleep well! Have a good night!  
la :: separates the adverb or phrase of context from the rest of the sentence
laso jelo :: green (yellowish blue) 
laso jelo / jelo laso :: yellowish blue (green) 
laso loje / loje laso :: reddish blue (purple) 
laso loje :: purple (reddish blue) 
laso :: [n][mod] blue, blue-green 
laso pimeja :: dark blue 
lawa e pilin :: to master one's feelings, be composed  
lawa :: [n] main, leader, in charge, the head, the mind  [v] to lead, control, rule, steer
len jan :: somebody's clothes 
len lawa :: hat, hood, bonnet, headdress 
len li lon poka mi :: The clothes are at my side
len li telo ala :: The clothes are dry
len luka :: gloves, mittens
len namako :: fashion accessory
len :: [n] clothes, article of clothing, cloth, fabric 
len ni li kule seme? :: What colour is this article of clothing? 
len noka :: shoe, pants 
len pi jan Lisa :: Lisa's clothes 
len pi jan Susan li jaki :: Susan's clothes are dirty
len pi loje en laso :: shirt of red and blue 
len sina li telo ala telo? :: Are your clothes wet? 
len supa :: tablecloth
lete lili li kin lon :: Here is it little cold too
lete lili li lon :: It's cool
lete li lon :: It's cold
lete mute li lon :: It's very cold
lete :: [n] cold   mod cold, uncooked  [v] cool down, chill, freeze 
letter :: pronounced as in
lili :: [mod] small, little, young, a bit, short, fes, less  [v] reduce, shorten, shrink, lessen 
linja lawa :: head-hair
linja lili oko :: eyebrows, eyelashes 
linja mi li telo :: My hair is wet
linja namako :: hair extensions, hairdressing work
linja :: [n] long, very thin, floppy thing; such as a string, line, rope, hair, thread, cord, or chain 
linja sinpin :: beard, facial hair 
linja uta :: moustache 
lipu :: [n] flat and bendable thing; such as paper, a card, or a ticket
lipu ni li pilin lete :: This paper feels cold
lipu pi tomo telo  :: toilet paper
lipu toki :: paper with written information; such as a document, text, or book 
li :: [sep] placed between any subject and its verb, except when the subject is "mi" or "sina"; also used to introduce a new verb for the same subject, whether or not "mi" or "sina" is used as the subject
loje jelo :: orange (yellowish red) 
loje laso (pimeja) :: (dark) blueish red, purple 
loje :: [n][mod]red 
loje walo :: light red, pink 
loje walo :: pink (whitish red) 
lon ala :: no, zero
lon anpa :: to be beneath
lon esun :: to do business, to be trading, to be at the market
lon ni ala :: far
lon ni :: near
lon :: [prep] be located in, at, or on  [v] be there, cause to exist, awaken from sleep  [mod] be present, be real, be true  [interj] yes (used rarely)
lon tenpo pi pali ala :: to be taking a sabbatical, break from work 
luka luka :: 5 + 5 = 10 
luka luka luka :: 5 + 5 + 5 = 15 
luka luka tu :: 5 + 5 + 2 = 12 
luka luka tu tu :: 5 + 5 + 2 + 2 = 14 
luka luka tu wan :: 5 + 5 + 2 + 1 = 13 
luka luka wan :: 5 + 5 + 1 = 11 
luka mi li jaki. mi wile telo e ona :: My hands are dirty, I want to wash them
luka :: [n] hand, arm  [mod] five
luka tu :: 5 + 2 = 7 
luka tu tu :: 5 + 2 + 2 = 9 
luka tu wan :: 5 + 2 + 1 = 8 
luka wan :: 5 + 1 = 6 
lukin e toki :: read 
lukin jo e pali :: to be looking for a job 
lukin :: [v] see, look at, watch, read, look, watch out, pay attention  [mod] visual, vision, sight
lupa jaki :: anus 
lupa kute :: ear 
lupa meli li mama ale :: A woman's womb is the mother of all things
lupa meli :: vagina
lupa monsi :: anus 
lupa nena :: nostrils 
lupa :: [n] hole, orifice, window, door
lupa ni li suli :: That hole is big
lupa pi telo jelo :: urethra
ma Akanisan :: Afghanistan 
ma Alan :: Ireland 
ma Alensina :: Argentina  
ma ali li pona :: All nations are good
ma Amelika lete :: North America
ma Amelika seli :: South America
ma Amelika :: the Americas
ma Anku :: Korea 
ma Antasika :: Antarctica
ma Antola :: Andorra
ma Apika :: Africa
ma Asija :: Asia
ma Awisi :: Haiti, Haitian Creole
ma Ekato :: Ecuador
ma Elena :: Greece
ma Elopa :: Europe
ma Elopa li weka tan ma Mewika :: Europe is away from the USA
ma Epanja :: Spain
ma Esi :: Estonia
ma Esuka :: Basque Country 
ma Ilakija :: Iraq 
ma Ilan :: Iran, Persia
ma Inli li pona :: England is good
ma Italija li pona lukin :: Italy is beautiful
ma kala :: land of the fish, fish land, the ocean
ma Kalalinuna :: Greenland, Greenlandic 
ma Kana :: Ghana
ma Kanata :: Canada
ma Kanata li pona :: Canada is good
ma Kanse :: France, French         
ma kasi :: forest, jungle 
ma Katala :: Qatar         
ma Katalunja :: Catalonia
ma Katelo :: Georgia 
ma Katemala :: Guatemala 
ma Kenata :: Grenada 
ma Kepeka :: Quebec
ma Keposi :: Cyprus 
ma Kinla :: Wales 
ma Konko (pi ma tomo Kinsasa) :: Congo, Democratic Republic  of
ma Konko (pi ma tomo Pasawi) :: Congo, Peoples Republic  of
ma Kosalika :: Costa Rica 
ma Kosiwa :: Côte d'Ivoire 
ma Kupa :: Cuba
ma Kusala :: Gujarat  
ma Kuwasi :: Kuweit 
ma Lanka :: Sri Lanka 
ma Lesi :: Brittany  
ma li lon anpa mi :: The land is beneath me 
ma Lipija :: Libya 
ma li pona lukin :: The countryside is good to look at
ma Lisensan :: Liechtenstein 
ma Lomani :: Romania
ma lon telo :: island 
ma Losi :: Russia 
ma Lowasi :: Croatia 
ma Lowenki :: Slovakia 
ma Lowensina :: Slovenia 
ma Lunpan :: Lebanon        
ma Lusepu :: Luxemburg 
ma Luwanta :: Rwanda 
ma Maketonija :: Macedonia 
ma ma kili :: land of vegetables, garden
mama kipisi: inventor-cut, part inventor, co-founder
ma Malakasi :: Madagascar, Malagasy 
ma Malasija :: Malaysia, Malay 
ma Malawi :: Malawi 
ma Mali :: Mali 
ma Malipe :: Morocco 
mama mama :: grandparent 
mama meli :: mother 
mama meli o awen :: Mama, wait
mama mije :: father 
mama mi li moli la mi pilin ike :: I feel bad because my parents died
mama :: [n] parent, creator, founder [mod] maternal, fatherly, parental
mama ona li kepeken e kasi nasa :: His mother used pot
ma Masija :: Hungary, Hungarian 
ma Masu :: Egypt 
ma Mesiko :: Mexico 
ma Mewika li weka ala tan ma Kupa :: The USA is not far away from Cuba
ma Mewika :: USA, American 
ma Mijama :: Myanmar
ma mi li pimeja :: My land is dark
ma Motowa :: Moldova         
ma Mulitanija :: Mauritania 
ma Namipija :: Namibia 
ma Naselija :: Nigeria 
ma Netelan :: Netherlands, Dutch 
ma Nijon :: Japan, Japanese 
mani lipu :: credit card, visa, mastercard
mani namako :: excess money
mani nanpa :: digital money, bitcoin
mani :: [n] money, material wealth, currency, dollar, capital
mani pi ma ante li pona tawa mi :: I like currency of other nations
ma Nise :: Niger 
ma :: [n] land, earth, country, (outdoor) area, ecology, region, outside area
ma Nosiki :: Norway, Norwegian Bokmål 
ma Nusilan :: New Zealand 
ma ona :: her country 
ma Ontula :: Honduras 
ma Osalasi :: Austria 
ma Oselija :: Australia 
ma Pakisan :: Pakistan 
ma Palakawi :: Paraguay 
ma Palani :: Bahrein 
ma Palata :: India 
ma Panama :: Panama 
ma Panla :: Bangladesh, Bengali 
ma Papeto :: Barbados 
ma Papuwanijukini :: Papua New Guinea 
ma Pasila :: Brasil 
ma Pawama :: Bahamas 
ma Pelalusi :: Belarus, Belarussian 
ma Pelu :: Peru 
ma Pemuta :: Bermuda 
ma Penesuwela :: Venezuela 
ma Penin :: Benin 
ma Pesije :: Belgium 
ma pi jan Keli :: Keli's country 
ma Pilipina :: Philipines 
ma Pilisin :: Palestine 
ma Pisi :: Fiji 
ma Piten :: Britain, UK
ma Pokasi :: Bulgaria, Bulgarian 
ma Posan :: Bosnia and Herzegovina 
ma Posuka :: Poland 
ma Potuke :: Portugal 
ma Samalino :: San Marino 
ma Sameka :: Jamaica
ma Samowa :: Samoa 
ma Sasali :: Algeria
ma Sawa :: Java
ma Sawasi :: Swaziland 
ma Seki :: Czech Republic 
ma seme li pona tawa sina? :: Which countries do you like? 
ma Seneka :: Senegal 
ma Setapika :: South Africa 
ma sike :: planet
ma sike suli :: planet
ma Sile :: Chile
ma sina :: your country 
ma Sinita :: Trinidad and Tobago
ma Sipusi :: Djibouti 
ma Sonko :: China
ma Sopisi :: Serbia 
ma Sukosi :: Scotland
ma Sulija :: Syria 
ma Sumi :: Finland
ma Sutan :: Sudan
ma Suwasi :: Switzerland, Swiss
ma Tansi :: Denmark
ma Tawi :: Thailand, Thai
ma telo :: mud, swamp 
ma Toko :: Togo 
ma Tominika :: Dominican Republic 
ma tomo Akajela :: Cairo (Egypt) 
ma tomo Alana :: Atlanta (USA) 
ma tomo Alawa :: Ottawa (Canada) 
ma tomo Alenta :: Atlanta
ma tomo Alipasi :: Halifax (Canada) 
ma tomo Anpu :: Hamburg (Germany) 
ma tomo Ansetan :: Amsterdam (Netherlands) 
ma tomo Asina :: Athens (Greece) 
ma tomo :: city, town 
ma tomo Ele :: Los Angeles (USA) 
ma tomo Esupo :: Espoo (Finland) 
ma tomo Iwesun :: Hilversum (Netherlands)  
ma tomo Kakawi :: Calgary (Canada) 
ma tomo Kenpisi :: Cambridge (USA, GB) 
ma tomo Kunte :: Bangkok (Thailand) 
ma tomo Lantan li suli :: London is big
ma tomo Lanten :: London (England)  
ma tomo lawa :: capital 
ma tomo Lesinki :: Helsinki (Finland) 
ma tomo Loma :: Rome (Italy) 
ma tomo Manten :: Moncton (Canada) 
ma tomo Mesiko :: Mexico City (Mexico) 
ma tomo Milano :: Milan (Italy) 
ma tomo Minsen :: Munich (Germany) 
ma tomo Monkela :: Montreal (Canada) 
ma tomo Napoli :: Naples (Italy) 
ma tomo Nujoka :: New York City (USA) 
ma tomo Osaka :: Osaka (Japan)  
ma tomo Paki :: Paris (France) 
ma tomo Pasen :: Boston (USA) 
ma tomo Pelin :: Berlin 
ma tomo Pelin :: Berlin (Germany) 
ma tomo Peminan :: Birmingham (England)  
ma tomo Pesin :: Beijing, Peking (China) 
ma tomo Pilense :: Florence (Italy) 
ma tomo Polan :: Portland (USA) 
ma tomo Putapesi :: Budapest (Hungary) 
ma tomo Sakata :: Jakarta (Indonesia) 
ma tomo Sanpansiko :: San Francisco (USA) 
ma tomo Sawi :: Sackville (Canada) 
ma tomo Sene :: Geneva (Switzerland) 
ma tomo Sensan :: St. John's (Canada) 
ma tomo Sesija :: Shediac (Canada) 
ma tomo Sije :: Dieppe (Canada) 
ma tomo Solu :: Seoul (South Korea) 
ma tomo Tanpele :: Tampere (Finland) 
ma tomo Telawi :: Tel Aviv (Israel) 
ma tomo Tokijo :: Tokyo (Japan)  
ma tomo Towano :: Toronto (Canada) 
ma tomo :: town 
ma tomo Tuku :: Turku (Finland) 
ma tomo Wankuwa :: Vancouver (Canada) 
ma tomo Wenesija :: Venice (Italy) 
ma Tona :: Tonga, Tongan 
ma Tosi :: Germany, German 
ma Tuki :: Turkey, Turkish 
ma Tunisi :: Tunisia 
ma Tuwalu :: Tuvalu 
ma Ukanta :: Uganda 
ma Ukawina :: Ukraine, Ukrainian 
ma Ulukawi :: Uruguay 
ma Uman :: Oman 
ma Utun :: Jordan
ma Wanuwatu :: Vanuatu 
ma Wasikano :: Vatican 
ma Wensa :: Sweden
meli en mije :: woman and man
meli insa :: person who identifies as female, such as a male-to-female transsexual person 
meli Italija :: Italian woman 
meli lili :: daughter 
meli li lon sewi mije :: woman on top 
meli li nasa e mije :: Women will drive men crazy
meli mije :: masculine girl, butch, tomboy 
meli mi pi nanpa wan li nasa :: My first girlfriend was crazy
meli :: [n] woman, female, girl, wife, girlfriend  [mod] female, feminine, womanly 
meli olin :: wife, girlfriend 
meli sama :: sister
meli unpa :: female sexual partner
mi anpa e jan utala :: I defeated the warrior
mi awen weka e ike tan ona :: I keep evil away from her
mi en meli mi li wan :: My girlfriend and I got married
mi en sina li jan pona :: You and I are friends
mi jan li suli :: I am somebody and am important
mi jan Pepe :: I am Pepe
mi jan pi toki pona :: I am a Toki Ponan
mije Epanja :: Spanish man
mije insa :: person who identifies as male, such as female-to-male transsexual person 
mije lili en meli lili li kipisi sama e linja ona :: The boy and the girl cut each other's hair
mije lili :: son
mije li lon sewi meli :: missionary position 
mije li moli la ona li toki wawa e "a!" :: When the man died, he screamed "aaarg!"
mije meli :: feminine guy 
mije :: [n] man, male, husband, boyfriend  [mod] male, masculine, manly 
mije (olin) :: husband, boyfriend 
mije sama :: brother 
mije unpa :: male sexual partner 
mije wan la nimi wan. meli wan la nimi awen :: One man one word, one woman one dictionary
mi jo e ilo :: I have a tool
mi jo e kili :: I have a fruit
mi jo e tomo tawa tu :: I own two cars
mi kalama kepeken ilo :: I make sound using an instrument
mi kama e pakala :: I caused an accident
mi kama jo e telo :: I got the water
mi kama lon ni kepeken nasin seme? :: How did I get up here?!
mi kama sona :: I'm learning
mi kama tan ma Elopa :: I come from Europe
mi kama tan ma Mewika :: I come from America
mi kama tan ma tomo Pelin :: I'm from Berlin
mi ken ala ken pilin e monsi sina? :: May I touch your butt? 
mi ken ala kute e toki sina :: I can't hear what you're saying
mi ken ala lape :: I can't sleep
mi ken ala. mi kin moku :: I can't, I'm still eating
mi kepeken e ilo :: I'm using tools
mi kepeken e poki e ilo moku :: I'm using a bowl and a spoon
mi kepeken e poki ni :: I'm using that cup
mi kin lukin e ona :: I see it indeed
mi kin olin e sina :: I still love you; I love you too
mi kin wile tawa tomo mi :: I still want to go to my house
mi kule e lipu :: I'm coloring the paper
mi kute e kalama musi :: I'm listening to music
mi kute e toki sina :: I hear your talking
mi lape ala :: I'm not sleeping
mi lape la ali li pona :: When I'm asleep, everything is good
mi lape. mi sona :: I sleep, I know
mi lawa pona e jan :: I lead people well
mi lon e sina :: I made you aware of reality, I forced you to be to present and alert
mi lon ma kasi :: I'm in the forest
mi lon tan seme?  :: Why am I here?  
mi lon tomo :: I'm in the house
mi lon :: Yes, I do
mi lukin ala e poki laso :: I don't see the blue bag
mi lukin e ma lon poka pi jan pona mi :: I look at the land with my friend
mi lukin e ma. ni li pona tawa mi :: I'm watching the countryside; this is good to me
mi lukin e ma poka jan pona mi :: I look at the land with my friend
mi lukin e ni :: I am looking at that
mi lukin e soweli luka :: I saw five mammals 
mi lukin e waso tu wan :: I saw three birds
mi lukin kepeken ilo suno :: I look using a flashlight
mi lukin sewi e tomo suli :: I am looking up at the big building
mi lukin taso e meli ni! ali li pona :: I only looked at that girl! Everything's okay
mi meli mi olin e meli :: I am a lesbian 
mi mije mi olin e mije :: I am gay
mi moku e kili e telo :: I eat fruit and drink water
mi moku e kili :: I eat fruit
mi moku :: I eat; I am food
mi moku :: I'm eating
mi moku kepeken ilo moku :: I eat using an eating utensil
mi moku lili e kili lili :: I nibble the small fruit
mi moku li pakala :: I eat and destroy
mi moku lon poka pi jan pona mi :: I ate with my friend
mi moku lon tomo :: I eat in the house
mi moku mute. sina moku lili :: I eat more than you
mi moku poka jan pona mi :: I ate beside my friend
mi moku tan ni: mi wile moku :: I eat because I'm hungry
mi musi ala :: I'm not having fun; I'm bored
mi musi taso :: I'm just joking
mi mute li lukin lili e ona :: We barely saw it
mi mute li moku e telo nasa mute :: We drank a lot of vodka
mi mute li pana e moku tawa ona mute :: We gave them food
mi mute o moku e kala :: Let's eat fish
mi mute o musi :: Let's have fun
mi mute o tawa :: Let's go
mi mute :: we, us
mi :: [n] I, we, me  [mod] mine, ours
mi olin e sina :: I love you
mi pali mute la mi pilin ike :: When I work a lot, I feel bad
mi pali taso :: I just work; all I ever do is work  
mi pana e ko jaki :: I crapped
mi pana e sona pi toki pona tawa ona :: I teach her toki pona
mi pana e telo jelo :: I peed
mi pana sona :: i'm teaching
mi pilin e ni: ona li jo ala e mani :: I think that he doesn't have money
mi pilin e ni: sina ike :: I think this: You're bad
mi pilin e seli sijelo sina :: I feel your bodily warmth
mi pilin ijo :: I'm thinking about something; I'm thinking something
mi pilin ike :: I feel bad; I feel sad
mi pilin lete :: I'm cold
mi pilin pi meli ni :: I'm thinking about that woman
mi pilin pona :: I feel good; I feel happy
mi pini e lape sina :: I ended your sleep; I woke you up
mi pona ala pona tawa sina? :: Do you like me?  
mi pona e ale mi, la mi pona e mi :: When I improve all areas of my life, I am making myself good
mi pona e ijo :: I'm fixing something
mi pona e ilo suno kepeken ilo lili :: I fixed the flashlight using a small tool
mi pona e tomo tawa jan pakala :: I fixed the house for the disabled man
mi pona :: I am good
mi pona tan ni: mi lon :: I'm okay because I'm alive
mi pona tan ni: mi sona e sina :: Pleased to meet you
mi pona. taso meli mi li pakala :: I'm okay, but my girlfriend is injured
mi sona ala e nimi pi ona mute :: I don't know their names
mi sona ala e tan :: I don't know the reason; I don't know why
mi sona e ni taso :: I know only that; that's all I know
mi suli :: I'm important; I'm fat
mi suli mute. sina suli lili :: I'm bigger than you
mi taso li lon :: I'm alone
mi tawa! :: Bye!  
mi tawa e kiwen :: I'm moving the rock
mi tawa :: I'm going; bye!
mi tawa :: I'm leaving, goodbye! Said by person leaving (see: tawa pona)
mi tawa ma Elopa :: I went to Europe
mi tawa supa lape :: I'm going to bed
mi tawa tomo mi :: I'm going to my house
mi tawa tomo toki. ona li pona tawa mi :: I like going to the chat room
mi telo e len :: I'm washing the clothes
mi telo e mi lon tomo telo :: I bathe myself in the restroom
mi toki jan :: I talked about people 
mi toki pi jan ike :: I talked about bad people
mi toki tawa sina :: I talk to you
mi utala ike :: I fight badly
mi wawa ala :: I'm not strong; I'm weak
mi weka e ijo tu ni :: I got rid of those two things
mi weka e ike jan la mi weka e ike mi :: When I forgive somebody's wrongdoings, I cleanse myself of negativity
mi weka :: I was away
mi wile ala e ijo. mi lukin taso :: I don't want anything, I'm just looking
mi wile ala pali :: I'm lazy
mi wile ala tawa musi :: I don't want to dance
mi wile ala toki pi kalama musi :: I don't want to talk about music
mi wile ala toki tawa sina :: I don't want to talk to you
mi wile e ilo moku :: I need a fork
mi wile e jan soweli lon insa pan :: I want a hamburger
mi wile e moku e telo :: I want food and water
mi wile e ni: mi lon tomo :: I want this: I'm at home
mi wile e sitelen ma :: I want the map
mi wile e soweli lili :: I want a puppy
mi wile e suwi! :: I want a cookie! 
mi wile e suwi sin! :: I want another cookie! 
mi wile kama sona e toki Inli :: I want to learn English
mi wile lon tomo :: I want to be at home; I want in a house
mi wile lukin e ma ante :: I want to see other countries
mi wile lukin e ma e suno :: I want to see the land and the sun
mi wile lukin e ma :: I want to see the countryside
mi wile lukin e tomo mi. taso mi lon ma ante :: I want to see my house, but I'm in a different country
mi wile moku e kili loje :: I want to eat a red fruit
mi wile moku e waso :: I want to eat chicken
mi wile moku. taso mi jo ala e moku :: I want to eat, but I don't have food
mi wile pakala e sina :: I must destroy you
mi wile pali kepeken nimi "lon" :: I need more practice with the word "lon"
mi wile pana e ko jaki :: I need to crap
mi wile pana e telo jelo :: I need to pee
mi wile sin e telo pi lape ala :: I need more coffee
mi wile tawa ma Oselija :: I want to go to Australia
mi wile tawa ma Tosi :: I want to go to Germany
mi wile tawa. taso mi ken ala   :: I want to go, but I can't
mi wile tawa tomo ona kepeken tomo tawa mi :: I want to go to his house using my car
mi wile tawa weka :: I want to leave
mi wile toki meli :: I want to talk about girls
mi wile unpa e ona :: I want to have sex with him/her
mi wile unpa e sina :: I want to have sex with you 
moku e telo nasa :: to drink alcohol 
moku e telo :: to drink 
moku kala :: food of fish, fish food; bait
moku lili :: pill, snack, small ingestible item 
moku lili pi pilin pona mute :: strong euphoric drug taken orally, such as MDMA 
moku li lon insa mi :: Food is in my stomach
moku li pona tawa ona :: He loves to eat
moku li pona :: The food is good
moku mi :: my food
moku :: [n] food, meal  [v] eat, drink, swallow, ingest, consume  
moku pi soweli moli :: meat
moku pi wawa mute :: fat food
moku pona! :: Good food! Enjoy your meal! 
moku suwi :: sweets, candy, chocolate 
moku telo :: liquid food, such as soup
moku tomo :: food done at home
moku walo :: whiteish food such as rice or plain yogurt
moli :: [n] death  [mod] dead, deadly, fatal  [v] to kill, to die, to murder
monsi kala :: fish butt, fish tail
monsi :: [n] back, ass, rear end, butt, behind  [mod] back, rear 
monsuta :: [n] creature that preys on humans, predator, real or imaginary threat, a danger, a source of fear  [mod] to be scary, to be a predator
mu :: [interj] woof! meow! moo!
mun lili tawa :: asteroid
mun li pimeja ale :: it's new moon 
mun li pimeja e suno :: solar eclipse 
mun li sike ale :: it's full moon 
mun :: [n]moon  [mod]lunar  
musi :: [n] fun, playing, game, recreation, art, entertainment  [mod] artful, fun, recreational  [v] play, have fun, entertain
musi pona! :: Good fun! Have fun! 
musi pona :: have a nice day, enjoy
mute ::  [n] amount, quantity  [mod] many, several, very, much, a lot, abundant, numerous, more  [v] make many or much  
mute seme? :: how much?
namako :: [n] food additive, salt, accessory, something extra, season  [v] to excite, to stimulate
nanpa lili :: few
nanpa :: [n] number, ordinal number (first, second, third, and so on)
nanpa pi ilo toki :: phone number 
nanpa pi ma tomo :: zip code 
nanpa pipi :: computer bug
nasa la :: foolishly
nasa lukin :: funny-looking 
nasa :: [mod] silly, crazy, foolish, drunk, strange, stupid, weird  [v] drive crazy, make weird 
nasa pona :: cheers, good health!
nasin ale :: The Way of Life 
nasin ante li pona tawa jan ante :: Different ways are good for different people
nasin li jo e telo kiwen :: the roads are icy 
nasin mani li ike :: Capitalism is negative
nasin :: [n] way, manner, custom, road, path, doctrine, system, method 
nasin pi suno kama :: east
nasin pi suno tawa :: west
nasin pi toki pona :: the ideology behind Toki Pona 
nasin pona Juju :: Unitarian Universalism  
nasin pona Latapali :: Rastafarianism
nasin pona li mute :: The good ways are man; there are many right ways of doing things 
nasin pona :: Taoism, simple or good path
nasin sewi Jawatu :: Judaism 
nasin sewi Kolisu :: Christianity 
nasin sewi ma :: any earth religion, such as Native American beliefs 
nasin sewi Puta :: Buddhism 
nasin sewi :: religion, spiritual path 
nasin sewi Silami :: Islam 
nasin tan :: original, unmodified, the first version 
nena kon :: nose
nena kute :: ear 
nena lawa :: nose
nena lili pi nena mama :: nipples 
nena lili unpa meli :: clitoris 
nena mama, nena meli  :: breasts 
nena meli :: breasts 
nena :: [n] bump, hill, mountain, button, nose 
nena sike meli :: female breasts, tits
nena suli li pana e ko seli :: a volcano is erupting 
ni ante :: there (not here)
ni li ike tawa mi :: That is bad to me;  I don't like that 
ni li jan lili ona pi nanpa tu :: This is her second child 
ni li jan seme? :: Who is that? 
ni li kule seme? :: What color is that? 
ni li musi ala musi? musi :: Is that funny? Yes
ni li pilin lete mute :: This is very cold
ni li pilin seli lili :: This feels warm
ni li pona tawa mi :: That is good to me;  I like that
ni li sewi sewi pi ma ale ni :: As the sun rises, you can almost see forever
ni li suwi ala suwi? :: Is that sweet?
ni li tawa jan pona mi :: This is for my friend
nimi kepeken @ :: email
nimi "lon" li pona ala tawa mi :: "lon" is not easy for me
nimi mi li Ken :: My name is Ken
nimi :: [n] word, name
nimi pi mi mute :: our names 
ni :: this, that, that one
noka :: foot, leg 
noka kala :: fish legs; fish tail
noka kasi :: roots of a tree
noka :: [n] leg, foot
o awen :: Wait
o jo e sijelo pona :: to your health 
o kalama ala! :: Don't make noise! 
o kalama ala :: shut up!
oko mi li lukin pona :: my eyes see well 
oko :: [n] eye 
oko sina li pona lukin :: You have beautiful eyes 
olin e jan mute :: to be polyamorous 
olin e meli e mije :: to love women and men 
olin e meli :: to love women 
olin e mije :: to love men 
olin :: [n] love  [mod] love  [v] to love (a person) 
olin suli li awen :: Old love never rusts
o lukin e ni :: Watch this
o lukin e pipi loje ni :: Look at that red bug
o lukin! meli ni li jo ala e len! :: Look! A naked woman!
o moli e pipi kepeken palisa :: Kill the roach with the stick
ona anu jan ante li ike? :: Is he bad, or is it the other person who's bad? 
ona li ike :: He is bad, I don't like him 
ona li jan pona pi kalama musi :: He is a good musician
ona li jo e monsi pona mute :: She has a very nice butt
ona li jo e seme? :: What does he have? 
ona li kama ante mute :: she changed a lot
ona li kama tawa ma mi :: He's coming to my country 
ona li kama tawa tomo mi :: He came to my house
ona li kule e tomo tawa :: He's painting the car
ona li lawa e jan tawa ma pona :: He led people to the good land 
ona li lon ala lon tomo? :: Is he in the house? 
ona li lon sewi mi :: He is above me
ona li lukin e pipi :: He's watching the bug 
ona li lukin sama pipi :: He looks like a bug 
ona li moku e kili :: She's eating fruit
ona li pali e ni kepeken nasin seme? :: How did she make that?  
ona li pona e ilo :: She's fixing the machine 
ona li pona :: It is good, I like it
ona li pona li lili :: It is good and is small
ona li seme? :: what are they like? 
ona li tawa ala tawa ma ike? :: Did he go to the evil land? 
ona li tawa ala telo :: He didn't go to the lake
ona li tawa e len mi :: She moved my clothes
ona li tawa sewi kiwen :: She's going up the rock 
ona li utala kepeken noka insa :: he attacked using the knee
ona li wile ala kute e ni :: He shouldn't hear this
ona li wile jo e ilo :: He would like to have a tool 
ona li wile mute e ni :: He wants that a lot
ona li wile pakala e pipi :: He wants to squish the spider
ona meli li toki e ni tawa mi: sina li lon ala la lon mi li jo e namako ala :: She told me that without me this life had nothing of interest for her
ona meli li wile poka ona = they (female) wants to be with her
ona mute li nasa e jan suli :: They drove the adults crazy
ona mute li tawa utala :: They're going to the war
ona mute li  utala toki :: They are arguing
ona mute :: they, them
ona :: [n] he, she, it, they  [mod] his, her, its, their 
o olin e jan poka :: Love thy neighbour
o open e lupa :: Open the door
o pali! :: work!
o pana e moku e mani! :: Give me the food and money!
o pana e pona tawa ma :: Love the earth; take care of our planet   
o pana e sike tawa mi :: Give the ball to me
o pana e sitelen ma tawa mi :: Give me the map 
o pana e suwi tawa mi! :: Give me a lollipop!  
open :: [n] the beginning, the start  [mod] beginning  [v]to open, to begin, to start, to turn on 
open pi tenpo esun :: monday, first day of week
o pilin e nena :: Touch the button
o pilin e uta mi kepeken uta sina :: Kiss me
o pona :: good luck!
o :: [sep] inserted before a command statement, or used after a name to address someone   [interj] Used when calling somebody's attention
o sina! ::
o sitelen e ni :: Please, write it down
o sona ala. o pali :: Stop thinking, do stuff
o sona e sina! :: Know thyself!  
o tawa! :: Go!
o tawa ma tomo poka jan pona sina :: Go to the city with your friend
o tawa musi poka mi!  :: Dance with me! 
o tawa tomo sina! :: Go to your house! 
o toki e ni sin :: Please, say that again
o toki kepeken tenpo mute :: Please speak more slowly
o tu :: Break up; split apart
o tu e palisa ni :: Split this stick 
o wan! :: Unite!  
o weka e ike mi :: Excuse me, Sorry
o weka e jan lili tan ni :: Remove the kid from here  
o weka e len sina :: Remove your clothes
pakala kepeken seli :: to burn
pakala :: [n] blunder, accident, mistake, destruction, damage, a break or fault  [v] screw up, fuck up, botch, ruin, break, hurt, injure, damage, bungle, spoil, ruin, fall apart   [interj] used as a swear word
pali ala :: not working, lazy
pali e ike tawa :: to do bad things to, to show disrespect for 
pali li ike tawa mi :: I'm lazy 
pali li pana e sona :: One learns by experience
pali li pana e sona :: Work gives you experience
pali mute a! :: What a lot of work!
pali :: [n] activity, work, deed, project  [mod] active, work-related, operating, working  [v] do, make, build, create
pali pona li lawa tawa lon :: good work is most importand in life; order is the half of life
pali pona :: order, good work
palisa li lawa e mije :: A man's penis controls him
palisa lili noka :: toes
palisa luka :: finger
palisa mije :: penis
palisa moli :: cigarette
palisa :: [n] long, mostly hard object; penis-shaped thing, dildo; rod; stick; pointy thing; tree branch
palisa sina li kiwen :: Your cock is hard
palisa tawa :: vibrating dildo
palisa uta :: tongue 
pali sin :: retry
pana e ko jaki :: to pooh, to shit 
pana e kon pi pilin pona :: to laugh 
pana e moku tan uta :: vomit
pana e moku tawa :: to feed, nourish 
pana e palisa lon lupa :: to penetrate 
pana e palisa uta lon :: to lick 
pana e pilin pona tawa :: to send positivity to, make feel good 
pana e sona :: to teach; to give knowledge
pana e supa sewi :: give a roof to protect from rain
pana e telo jelo :: to pee, to urinate 
pana e telo oko :: to cry, weep 
pana e telo walo mije :: to ejaculate
pana e uta lon lupa meli :: to perform cunnilingus 
pana e uta lon palisa :: to fellate 
pana e uta tawa ona :: to kiss 
pana lon esun :: to give at the market, trade, sell
pana :: [v] give, put, send, place, release, emit, cause  [n] giving, transfer, exchange 
pana wawa :: BDSM
pan :: [n] bread, cereals, pasta, rice
pan suwi :: sweet cookie, sugar cookie
pilin ala :: indifferent, unfeeling 
pilin e ike jan :: to pity somebody, feel bad for somebody 
pilin e moli jan :: to mourn somebody 
pilin e weka jan :: to miss somebody 
pilin ike tan :: be afraid of, sad because of, regret, be offended by 
pilin ike tawa :: to have negative feelings for, be upset at, angry at, hate, resent 
pilin ike :: to feel bad, sad, depressed, unhappy, bitter, discontented, grumpy 
pilin ike wawa :: to have intense negative feelings, be pissed off, furious 
pilin kepeken e nena lawa :: smell
pilin nasa :: drunk, high, to feel silly, strange, weird, crazy, drunk, high  
pilin :: [n] feelings, emotion, heart  [v] feel, think, sense, touch 
pilin pona li pana e sijelo pona :: Positive feelings grant good health; mind over matter   
pilin pona mute :: to feel great, amazing, awesome 
pilin pona tan :: to feel good because of, to enjoy 
pilin pona :: to feel good, happy, content, enjoy oneself, comfortable 
pilin wawa :: to feel strong, energetic, excited, confident, proud
pilin wawa unpa :: orgasm 
pimeja laso :: blueish black 
pimeja li lon :: it is night 
pimeja li tawa insa kon mi :: Darkness fills my soul
pimeja :: [mod] black, dark  [n] darkness, shadows  [v] darken 
pini li pona la ale li pona :: Is the end good -- everything is good
pini :: [n] end, tip  [mod] completed, finished, past, done, ago  [v] finish, close, end, turn off  
pini palisa :: glans, head of the penis 
pini pi nena mama :: nipples 
pini pi sike suno :: end  of the year
pini pi wan musi :: end level
pipi :: bug, of bug  
pipi li lon ala lon poka mi? :: Is a bug beside me?
pipi li lon anpa mi :: The bug is underneath me
pipi li lukin li unpa :: The bug looks and has sex
pipi li moku ala moku e kili? :: Are the bugs eating the fruit? 
pipi li moku e kasi :: Bugs eat plants
pipi li moku e mi :: The mosquito bit me
pipi li moli :: The bug is dead
pipi li wile moku e telo :: The bug is thirsty
pipi :: n bug, insect, spider 
pipi seme li pakala e sina? :: Which bug hurt you?  
pi :: [sep] essentially means "of" 
pi :: sep of, belonging to 
poka mi li pakala :: My hip hurts
poka :: n side, hip, next to   mod neighboring   prep in the accompaniment of, with 
poka :: side, hip, close to, nearby 
poka telo :: water side, the beach
poki kon :: lungs
poki lete :: fridge, refrigerator 
poki :: [n] container, box, bowl, cup
poki ni li lon jaki :: That bottle is in the dirt
poki seli :: oven, microwave 
poki sike :: glass
poki telo :: sink, bathtub, bottle, glass
poki walo :: egg
pona e pilin jan :: cheer up, make somebody happy 
pona la :: fortunately
pona lukin :: pretty, attractive, beautiful, pretty, handsome 
pona! mi kin tawa ma Elopa :: Cool! I also went to Europe
pona moku :: delicious, tasty 
pona :: [n] good, simplicity, positivity  [mod] good, simple, positive, nice, correct, right  [interj] great! good! thanks! OK! cool! yay! 
pona unpa :: sexy, good in bed
pu lili :: small book, novellette
pu :: [n] book, tokipona nirvana (jan Sonja), maybe usable as comma (punctuation)
pu ni li toki e ni: jan utala pona li moli e akesi monsuta :: This book is about a knight who kills a dragon
pu pi jan lili :: childrens book
pu suli :: large book, novel
room, building 
sama la :: similarily
sama li ike :: Equality is bad
sama :: [mod] same, similar, equal, of equal status or position  [prep] like, as, seem  [cont] similarly, in the same way that
seli kon :: smoke
seli lili li lon :: It's warm
seli li lon :: it's warm or hot 
seli li lon la mi pana e telo tan selo mi :: When it's hot, I sweat
seli mute li lon :: It's very hot
seli :: [n] fire, warmth, heat  [mod] hot, warm, cooked  [v] heat, warm up, cook, burn
seli pakala :: explossion
seli sewi :: lightning
seli suno li seli e tomo mi :: The sun's warmth heats my home
seli suno :: the sun's heat 
selo lon pini palisa :: foreskin 
selo mi li wile e ni: mi pilin e ona :: My skin wants this: I touch it
selo :: [n] outside, surface, skin, shell, bark, shape, peel 
seme li lon poka mi? :: What is beside me? 
seme li lon tomo mi? :: What is in my house? 
seme li moku e kili mi? :: What is eating my fruit? 
seme li olin? :: what is love?
seme li pona tawa sina? :: What do you like?
seme li utala e sina? :: What attacked you? 
seme :: [question] what, where, which, who, how many, and so on (used to make question sentences) 
sewi li laso :: The sky is blue
sewi monsi :: upper back, shoulders 
sewi :: [n] sky, roof, top [v] high, up, above, top, over, on, sanctify  [mod] superior, elevated, religious, formal, holy
sewi pi sinpin lawa :: forehead 
sijelo namako :: piercing, tattoo, body art
sijelo :: [n] health, body, physical state
sike e suno nunpa wan :: first aniversary, when born
sike mama waso :: egg 
sike mije :: man's testicles 
sike :: [n] circle, wheel, sphere, ball, cycle  [mod] round, cyclical 
sike suno wan :: one year
sina jo e kili anu telo nasa? :: Do you have the fruit the wine? 
sina kama anu seme? :: Are you coming or what?  
sina kama e ni: mi wile moku :: You caused this: I want to eat; you made me hungry
sina kama jo e jan pona lon ni :: You will get friends there
sina kama tan ma seme? :: Which country do you come from?
sina kama tan seme? :: Why did you come?
sina ken ala ken kama?  :: Can you come?
sina ken ala ken lape? :: Can you sleep?
sina kepeken ala kepeken e ni?  :: Are you using that?
sina lon ala lon ma tomo Wankuwa? :: Do you live in Vancouver?
sina lon ma tomo seme? :: What city do you live in?
sina lon seme? :: Where are you?
sina lukin ala lukin e kiwen? :: Do you see the rock?
sina lukin ala lukin e sitelen tawa X-Files? :: Do you watch The X-Files?
sina lukin e jan seme? :: Whom did you see?
sina lukin e pipi :: You're watching a bug
sina lukin e seme? :: What are you watching? 
sina lukin sewi e suno :: You look up at the sun 
sina moku e telo nasa la sina nasa :: If you drink beer, you'll be silly
sina moli la sina ken ala toki :: If you are dead, you can't speak
sina nimi li seme :: What's your name?
sina :: [n] you  [mod] your 
sina pakala e ilo kepeken nasin seme?  :: How did you break the tool?
sina pakala e seme? :: What did you hurt?
sina pali e ni kepeken nasin seme? :: How did you make this?
sina pana ala pana e moku tawa jan lili? :: Did you give food to the child? 
sina pana e ike la sina kama jo e ike :: If you give evil, you will receive evil
sina pilin e seme? :: What are you thinking? / What do you think?
sina pilin seme? :: how are you? how are you feeling? how do you feel?
sina pona ala pona? :: Are you okay? 
sina pona :: You are good; you fix
sina sona ala sona e toki Inli? :: Do you speak English? 
sina sona ala sona e toki mi? :: Do you understand what I'm saying? 
sina sona e toki ni la sina sona e toki pona! :: If you know what this says then you know toki pona!
sina suli :: You are tall
sina tan ma seme :: Where are you from?
sina tawa ma tomo tan seme?  :: Why did you go to the city? 
sina tawa poka jan seme? :: Whom did you go with?
sina toki e ni tawa mi: sina moku :: You told me that you are eating
sina toki pi mama anu jan lili? :: Are you talking about the parent, or is the child that you're talking about? 
sina toki tawa jan seme? :: Whom are you talking to? 
sina toki tawa mi anu ona? :: Are you talking to me, or are you talking to him? 
sina toki tawa mi anu seme? :: You ask me? 
sina wile ala wile moku? :: Do you want to eat? 
sina wile ala wile pali? wile ala :: Do you want to work? No
sina wile e mani anu seme? :: Do you want the money or what? 
sina wile e moku anu telo? :: Do you want food, or do you want water?
sina wile kama anu seme? :: Do you want to come or what?
sina wile kama tawa tomo toki :: You should come to the chat room
sina wile kepeken e ilo :: You have to use tools
sina wile moku anu seme? :: Do you want to eat or what? 
sina wile pali e seme? :: What do you want to do?
sina wile tawa ma seme? :: What place do you want to go to?
sina wile tawa telo suli :: You want to go to the ocean
sina wile toki e tan tawa mi :: You have to tell me why
sina wile toki tawa mije anu meli?  :: Do you want to talk to a male, or a female? 
sin en ante li sin e lawa li pana e sona :: Novelty and change freshen the mind and bring insight
sin :: [mod] new, fresh, another, more  [v] renew, renovate, freshen
sinpin lawa :: face
sinpin :: [n] front, chest, torso, abdomen, face, wall
sitelen ma :: map 
sitelen :: [n] picture, image  [v] draw, write 
sitelen pi ilo nanpa :: computer screen 
sitelen tawa "Bowling for Columbine" li kin pona :: The movie "Bowling for Columbine" is also good
sitelen tawa "Fahrenheit 9/11" li pona tawa mi :: I like the movie "Fahrenheit 9/11"
sitelen tawa :: movie, TV show 
sitelen toki :: writing
sitelen unpa :: visual erotica, porn
sona e toki :: to know, speak, understand a language
sona mute :: smart, intelligent, wise
sona :: [n] knowledge, wisdom, intelligence, understanding  [v] know, understand, know how to 
sona pona e toki :: to master a language
sona pona li sona sewi ala. ona li sona mute ale :: real inteligence is not to know things, it is to know a lot of things
soweli li kama moli :: The cheetah is dying
soweli lili pi ilo nanpa :: computer mouse 
soweli li toki e mu :: Cows say moo
soweli mi li kama moli :: My dog is dying
soweli :: [n] animal, lovable animal, mammal, meat from a mammal such as beef or pork
soweli ni li pona moku :: This cow is good to eat
suli :: [mod] big, tall, fat, long, adult, important  [v] enlarge, lengthen  [n] size   
suno li jelo :: The sun is yellow
suno li lon :: It's sunny
suno li lon poka pimeja :: Light is beside darkness; opposites are interconnected; yin and yang
suno li lon sewi mi :: The sun is above me
suno li lon sewi :: The sun is in the sky
suno li suli ala suli? :: Is the sun big? 
suno li suli :: The sun is big
suno :: [n] sun, light [mod] sunny, shiny, of or relating to the sun, daylight
suno pona! :: Good sun! Good day!
supa lape :: bed
supa lawa :: pillow
supa li pona :: the floor is clean, good
supa moku :: dinner table
supa monsi :: chair, couch
supa :: [n] horizontal surface such as furniture; a table, chair, or pillow; the floor
supa pali :: work desk
supa pi lupa tomo :: window cristal
suwi lukin :: cute
suwi :: [n] candy, sweet food, cookie  [mod] sweet, cute  [v] sweeten
tan :: [prep] from, by, because of, since  [n] origin, cause, reason
taso :: [mod] only, sole  [conj] but
tawa kala :: movement of a fish, swim
tawa lon monsi = go behind
tawa ma lete tawa soweli walo :: north
tawa ma lete tawa waso walo pimeja :: south
tawa musi :: resume, dance, perform
tawa pona! :: Go well! Good bye! Bon voyage
tawa pona :: Leave well, goodbye! Said by person not leaving (see: mi tawa)
tawa :: [v] to go to, to move, to, for  [prep] to, in order to, towards, for, until  [n] movement, transportation  [mod] moving, mobile
telo e luka :: wash your hands
telo e mi :: to shower
telo jaki lon nena sinpin :: snot
telo jelo :: urine, pee (yellow fluid)
telo kili :: juice
telo kili ni li suwi :: This fruit drink is sweet
telo kiwen :: ice
telo kiwen ko :: snow
telo kiwen lili li kama :: it's hailing
telo li kama :: it's raining
telo lili :: droplet, drops
telo lili li lon kon :: it's humid
telo linja :: river
telo li pona :: Water is good (or simple)
telo li suli :: The lake is big
telo loje :: blood
telo (loje) mun :: menses 
telo mama soweli :: cow milk
telo nasa :: alcohol, such as beer, wine, whisky
telo nasa loje seli :: mulled claret (hot wine)
telo nasa loje :: wine
telo nasa pi wawa ala :: weak beer, US American beer 
telo nasa pona! :: generic toast 
telo nasa wawa :: vodka, whisky, 
telo :: [n] water, liquid, juice, sauce, beverage  [v] water, to wash
telo ona :: her water 
telo pi lape ala :: coffee 
telo seli :: hot beverage, such as coffee or hot cocoa
telo seli jelo :: green tea  
telo seli pimeja pi lape ala :: coffee 
telo seli wawa :: coffee 
telo sijelo loje :: blood or any red bodily fluid
telo suli li ike tawa mi :: I don't like the ocean
telo suli li laso :: The big water [ocean] is blue
telo suli :: sea, ocean
telo tawa :: to swim, river, flow
telo walo mije :: sperm
telo wawa :: energy drink  
tenpo ala :: never 
tenpo ali :: always, all the time 
tenpo ali la o kama sona!  :: Always learn!  
tenpo jelo :: summer - yellow for the sun (see: tenpo seli)
tenpo kama la mi lape :: In the future, I'll sleep
tenpo kama lili :: soon, after
tenpo kama :: the future
tenpo laso :: spring - blue water, green for plants (see: tenpo seli lili)
tenpo lete lili :: autumn (see: tenpo loje)
tenpo lete :: winter  (see: tenpo walo)
tenpo lili la mi wile weka :: I must leave soon
tenpo lili :: soon, moment, briefly  
tenpo li sijelo e sijelo ike ali :: The time heals all wounds
tenpo li tawa la sona li kama :: Time comes -- advice comes
tenpo loje :: autumn - red for autumn leaves (see: tenpo lete lili)
tenpo moku :: mealtime 
tenpo mun kama :: next month
tenpo mun :: month 
tenpo mun ni :: this month 
tenpo mun pi nanpa luka luka :: October 
tenpo mun pi nanpa luka luka tu :: December 
tenpo mun pi nanpa luka luka wan :: November 
tenpo mun pi nanpa luka :: May  
tenpo mun pi nanpa luka tu :: July 
tenpo mun pi nanpa luka tu tu :: September 
tenpo mun pi nanpa luka tu wan :: August 
tenpo mun pi nanpa luka wan :: June  
tenpo mun pi nanpa tu :: February 
tenpo mun pi nanpa tu tu :: April 
tenpo mun pi nanpa tu wan :: March 
tenpo mun pi nanpa wan :: January 
tenpo mun pini :: last month
tenpo mute :: sometimes, usually, often, many times 
tenpo ni la mi lon :: At this time, I am here
tenpo ni :: now, the present (this time) 
tenpo :: [n] time, period of time, moment, duration, situation 
tenpo pimeja :: night, dark times
tenpo pimeja ni la mun li suli :: The moon is big tonight
tenpo pimeja ni :: tonight
tenpo pimeja pini la mi kama nasa :: Last night, I became drunk
tenpo pimeja pini la mi lukin e sitelen tawa X-Files   :: Last night I watched X-Files
tenpo pimeja pini :: last night
tenpo pi mute seme la sina sike e suno? :: How old are you? 
tenpo pini la mi weka :: In the past, I was away
tenpo pini :: the past
tenpo pona Kolisu :: Christmas 
tenpo pona la mi lon! :: I'm back, and just in time!
tenpo seli lili :: spring (see: tenpo laso)
tenpo seli :: summer (see: tenpo jelo)
tenpo seme la ona li kama lon tomo sina? :: When is he coming to your house? 
tenpo seme :: when
tenpo sike :: year 
tenpo sin :: again 
tenpo sitelen :: calendar, schedule
tenpo suli :: long time 
tenpo suno :: day
tenpo suno kama la mi pali e lipu sin :: I'll update my web page tomorrow
tenpo suno kama la mi wile pali :: I have to work tomorrow
tenpo suno kama :: tomorrow
tenpo suno luka tu :: week
tenpo suno ni :: today
tenpo suno pi nanpa luka :: Friday 
tenpo suno pi nanpa luka tu :: Sunday 
tenpo suno pi nanpa luka wan :: Saturday 
tenpo suno pi nanpa tu :: Tuesday 
tenpo suno pi nanpa tu tu :: Thursday 
tenpo suno pi nanpa tu wan :: Wednesday 
tenpo suno pi nanpa wan :: Monday 
tenpo suno pini :: yesterday 
tenpo suno pi pali ala :: public holiday 
tenpo suno pi pini mute la mi tawa tomo :: I went home a while ago
tenpo suno pi sike e suno :: birthday
tenpo suno sin ali la sina moku e telo seli pimeja :: Every morning I drink coffee
tenpo suno sin :: morning 
tenpo telo :: rainy season 
tenpo tu tu la mi sike e suno :: I am 4 year old; lit: Four times I circled the sun
tenpo walo :: winter - white for snow (see: tenpo lete)
toki Alapi :: Arabic 
toki ali o :: hello everybody!
toki ante :: a dialect of tokipona that adds or changes words to the original language as developed by jan Sonja; this is usually done by conlang fans
toki Apikan :: Afrikaans 
toki Awasa :: Hausa 
toki Epelanto :: Esperanto 
toki Ewantalu :: Ewantal 
toki! :: Hello!, Hi!
toki ike lon :: to say bad things about, complain about 
toki ike tawa :: to say bad things to, insult, speak rudely to 
toki ike :: to say negative things; a "dialect" specifically characterized by gramatically wrong toki pona
toki Inli :: English
toki Inli li pona :: The English language is good
toki Inli pona :: Basic English
toki Insi :: Hindi
toki Intelinka :: Interlingua
toki Iwisi :: Hebrew
toki Jolupa :: Yoruba 
toki Kalike :: Scots Gaelic 
toki Kanse :: French language 
toki Kantun :: Cantonese 
toki Kisawili :: Swahili 
toki Kuwenja :: Quenya, Elvish 
toki li ni :: it says
toki li pona :: communication is good
toki li pona tawa mi :: I like talking; I like languages
toki Lolan :: Loglan         
toki Loma :: Latin 
toki lon toki :: to speak in a language 
toki Losupan :: Lojban 
toki Lunasimi :: Quechua 
toki Malasi :: Marathi 
toki nanpa wan :: primary language 
toki nasa :: a dialect of tokipona more expressive and less philosophical than original dialect developed by jan Sonja
toki :: [n] language, speech, story, phrase [interj] hey! [v] to talk, to speak, to comunicate, to say or chat
toki Nosiki sin :: Norwegian Nynorsk 
toki Olapu :: Volapük 
toki Pansapi :: Punjabi 
toki Pasiki :: Fyksian 
toki Pasuto :: Pashto 
toki pona e toki :: to speak a language well 
toki pona li pona tawa mi :: I like Toki Pona
toki pona li toki pona :: Toki Pona is a good language
toki pona lon :: to say good things about, praise  
toki pona pi nasin nanpa :: a "dialect" of tokipona which could be written by computers, would use short sentences, could be verifiably grammatically correct; and could be used by robots; this is the most direct subset of the original dialect developed by jan Sonja
toki pona pi nasin tan :: the original tokipona dialect as developed by jan Sonja (for more information on dialects, see: http://www.suburbandestiny.com/?p=799 )
toki pona tawa :: to say nice things to, compliment 
toki pona :: Toki Pona, to say nice things, the good talking
toki Sami :: Laplander 
toki Sankitu :: Sanskrit 
toki Sinan :: Klingon 
toki sitelen :: written language 
toki sona :: proverbs 
toki suli :: conference talk, discourse
toki Tamasiko :: Berber, Tamazight 
toki Tami :: Tamil 
toki Teluku :: Telugu 
toki utala tawa :: to argue with, criticize 
toki Utu :: Urdu 
tomo lape :: bedroom 
tomo mani :: bank 
tomo mi li weka tan ni :: My house is away from here
tomo mi :: my house 
tomo moku :: (place to eat) grocery store, restaurant, dining room, kitchen, grocery store
tomo esun :: market (stocks)
tomo moku li kama open ala open? :: will the food shop be open or not?
tomo moku li open ala open? :: is the food shop open?
tomo :: [n] a building or construction such as a house or home  [mod] urban, domestic, household 
tomo pali :: work(place), office, factory
tomo pi ijo kama jo :: shop
tomo pi jan Keli en mije ona li suli :: The house of Keli and her boyfriend is big
tomo pi jan Lisa :: Lisa's house 
tomo pi mi mute li pakala :: Our house is messed up
tomo pi ona mute :: their house 
tomo pi telo en moku pana :: restaurant 
tomo pi telo nasa :: building of alcohol; a bar, pub
tomo sona :: school, university 
tomo tawa :: car (moving construction) 
tomo tawa kon :: airplane, helicopter 
tomo tawa linja :: train
tomo tawa sina li pakala ala pakala? :: Is your car messed up? 
tomo tawa suli :: bus
tomo tawa telo :: boat, ship 
tomo telo :: bathroom, toilette, water closet, restroom
tomo telo li lon seme? :: Where's the bathroom?
tomo toki :: chat room, conference room 
tomo unpa :: sex place, such as a bedroom, boudoir, brothel, sex house, or brothel
tu :: [n] 2, duo, pair  [mod] two  [v] double; separate, cut, or divide in two 
tu tu :: 2 + 2 = 4 
tu wan :: 2 + 1 = 3 
unpa e palisa meji kepeken uta sinpin :: giving a blowjob
unpa li pona :: sex is good, I like sex
unpa nasa :: kinky sex 
unpa :: [n] sex, sexuality [mod] sexual, erotic  [v] to fuck, to have sex with, sleep with
unpa sama soweli :: doggy style 
unpa uta :: oral sex, cunnilingus
utala li ike :: Conflict is bad
utala li ike tawa mi :: I don't like wars
utala :: [n] conflict, disharmony, competition, fight, war, battle, attack, blow, argument, physical or verbal violence   [v] hit, strike, attack, compete against 
uta :: [n] mouth  [mod] oral
walo :: [mod] white, light colour  [n] a white thing or part, whiteness, lightness
walo pimeja :: grey (dark white) 
walo uta :: teeth  
wan :: [mod] one, a  [n] unit, element, particle, part, piece  [v] unite, make one 
wan sijelo :: body part 
wan taso :: alone
waso ike li tawa sike lon lawa mi :: crows fly above my head in circles
waso kala :: fishy bird; a bird that swims or dives for food
waso li ken ala lukin la ona li kin ken jo e kili :: A blind chicken can find a corn too
waso li tawa lon kon :: Birds fly in air
waso :: [n] bird, winged animal 
wawa kon :: eolic energy
wawa li lon insa :: Energy comes from inside; youth is all in the heart
wawa :: [n] energy, strength, power  [mod] energetic, strong, fierce, intense, sure, confident  [v] strengthen, energize, empower
weka e ike jan :: forgive somebody
weka lili li pona tawa lawa :: Temporary isolation is good for meditation
weka :: [n] away  [v] to remove, to eliminate, missing, absence, throw away, get rid of  [mod] not present
weka sona :: forget
wile e pona tawa jan :: to wish somebody well 
wile ike :: to have negative intentions, malevolent 
wile lape :: to be tired, sleepy, wanting to rest 
wile lawa :: to be dominant  
wile moku e telo :: to be thirsty
wile moku :: hungry, to be hungry
wile moli e jan :: homicidal, wanting to murder
wile moli :: suicidal
wile mute ike :: to want too much, greedy
wile mute :: to crave, really want
wile pali e ijo :: bored, wanting to do something
wile pana e pona tawa jan :: helpful to someone
wile pi jan ike li pakala e ijo :: The desires of evil people mess things up
wile pona :: to have good intentions, mean well
wile sona li mute e sona :: Curiosity feeds wisdom; one learns by asking questions
wile unpa e meli e mije :: to be sexually attracted to women and men
wile unpa e meli :: to be sexually attracted to women
wile unpa e mije :: to be sexually attracted to men
wile unpa :: horny, lustful
wile :: [v] to want, need, wish, have to, must, will, should  [n] desire, need, will  [mod] necessary
