a :: межд. а! ха! о! ой!
akesi :: сущ. неприятное животное, рептилия, пресмыкающееся
ala :: прил. не, нет, не-, сущ. ничего, отрицание, ноль, межд. нет!
ali, ale :: (оба варианта правильные); сущ. всё, каждое, жизнь, вселенная; прил. все, каждый, целый, полный
anpa :: сущ. низ, нижняя часть, под, пол, ниже; прил. низ, ниже, вниз
ante :: сущ. отличие; прил. отличный, другой; cont иначе; пер. гл. изменить, сменить
anu :: союз или
awen :: гл. оставаться, ждать, пребывать; пер. гл. хранить; прил. оставшийся, неподвижный, постоянный, сидячий, оседлый
e :: разд. (разделяет сказуемое и дополнение)
en :: союз и (используется для соединения подлежащих)
ijo :: сущ. вещь, что-то, объект; прил. из чего-то; пер. гл. воплощать
ike :: прил. плохой, отрицательный, неправильный, злой, слишком сложный, (образно) больной; межд. жаль! увы!; сущ. вредность, негодность, злость; пер. гл. сделать плохим, ухудшить, вызвать негативный эффект; гл. быть плохим
ilo :: сущ. инструмент, устройство, приспособление, механизм, аппарат, машина, прибор; вещь, использемая для определённой цели
insa :: сущ. внутри, внутренний мир, центр, живот, желудок; прил. внутренний
jaki :: прил. грязный, грубый, мерзкий; сущ. грязь, загрязнение, мусор, брань; пер. гл. загрязнять, грязный; межд. фу! ew! yuck!
jan :: сущ. человек, люди, кто-то; прил. человеческий, чей-то, личный; пер. гл. олицетворять, очеловечивать
jelo :: прил. жёлтый, светло-зелёный
jo :: пер. гл. иметь, содержать; сущ. имущество, собственность; kama получить, взять
kala :: сущ. рыба, морское животное
kalama :: сущ. звук, шум, голос; гл. шуметь; пер. гл. звонить, играть (на инструменте)
kama :: гл. подходить, приходить, прибывать, случаться, начинать, приводить в состояние; сущ. событие, происшествие, шанс, прибытие, начало; прил. наступление, будущее; пер. гл. принести, вызвать
kasi :: сущ. растение, лист, дерево, трава
ken :: гл. мочь, разрешать, сделать возможным; сущ. возможность, разрешение, способность; пер. гл. сделать возможным, разрешить; cont возможно, что …
kepeken	:: (пер) гл. использовать (prep) с помощью
kili :: сущ. плод, фрукт, овощ, гриб
kin :: прил. также, даже, (усиливает слова, перед этим словом)
kiwen ::прил. твёрдый, сплошной, каменный, металлический; сущ. твёрдая вещь, скала, камень, металл, земля
ko :: сущ. вязкая субстанция, резина, порошок
kon :: сущ. воздух, ветер, запах, душа, дух; прил. воздушный, неземной, газообразный
kule :: сущ. цвет, краска; прил. цветной; пер. гл. красить
kute :: пер. гл. слушать; прил. слуховой, слух
kulupu :: сущ. группа, сообщество, сомпания, люди (прил) общий, публичный, совместный
la :: разд. (разделитель между наречием или фразой контекста и предложением)
lape :: n, vi сон, отдых (прил) спать, сонный
laso :: прил. синий, сине-зелёный
lawa :: сущ. голова, ум (прил) главный, лидирующий (пер) гл. управлять, контролировать, направлять
len :: сущ. одежда, ткань
lete :: сущ. холод (прил) холодный, неприготовленный (пер) гл. охладить, заморозить
li :: разд. разделяет подлежащее (кроме mi и sina) и сказуемое; также используется для представления нового глагола для существительного
lili :: прил. маленький, молодой, немного, мало (пер) гл. уменьшать, сокращать
linja :: сущ. длинный, очень тонкий предмет, верёвка, нитка, волос, цепь
lipu :: сущ. плоский и гибкий предмет, бумага, карточка, билет
loje :: прил. красный
lon :: prep быть в, располагаться (гл) быть, присутствовать, существовать (сущ) правда
luka :: сущ. рука
lukin :: пер. гл. смотреть, видеть, наблюдать, читать (прил) визуальный, видимый
lupa :: сущ. дыра, отверстие, окно, дверь, проход
ma :: сущ. земля, страна, пространство, место
mama :: сущ. родитель, мама, папа (прил) родительский, отцовский, материнский
mani :: сущ. деньги, материальные блага, богатство
meli :: сущ. женшина, девочка, жена, подружка (прил) женский
mi :: сущ. я, мы (прил) мой, наш
mije :: сущ. мужчина, муж, бойфренд (прил) мужской
moku :: сущ. еда, питание (пер) гл. есть, пить, глотать, потреблять
moli :: сущ. смерть (гл) умереть, быть мёртвым (пер) гл. убить (прил) мёртвый, убийственный, фатальный
monsi :: сущ. зад, сзади (прил) задний
mu :: межд. гав! мяу! му! (голос животного)
mun :: сущ. луна (прил) лунный
musi :: сущ. развлечение, игра, отдых, искусство (прил) искусный, смешной, развлекательный (гл) играть, развлекаться (пер) гл. развеселить
mute :: прил. много, очень, несколько, больше (сущ) число, количество (пер) гл. увеличить
nanpa :: сущ. число
oth(порядковое числительное)
nasa :: прил. тупой, сумасшедший, пьяный, странный (пер) гл. сводить с ума, чудить
nasin :: сущ. дорога, путь, выбор, доктрина, метод
nena :: сущ. шишка, выпуклость, нос, холм, гора, кнопка
ni :: прил. это, этот
nimi :: сущ. слово, имя
noka :: сущ. нога
o :: разд. (обращение или повелительное наклонение) (межд) эй! (привлечь чьё-то внимание)
oko :: сущ. глаз
olin :: n любовь (прил) любимый (пер) гл. любить (человека)
ona :: сущ. он, она, оно, это, они (прил) его, её, их
open :: пер. гл. открыть, включить
pakala :: сущ. промах, происшествие, ошибка, разрушение, ущерб, сломанный (пер) гл. разрушить, сломать, повредить (гл) разрушиться, сломаться, развалиться (межд) чёрт!
pali :: сущ. активность, деятельность, работа (прил) активный, рабочий (пер) гл. делать, создавать, строить, работать
palisa :: сущ. длинный, твёрдый объект, палка, ветка
pana :: пер. гл. давать, класть, посылать, выпускать, вызывать (что-либо) (сущ) передача, обмен
pi :: разд. из, of, (разделитель в составных словах)
pilin :: сущ. чувства, эмоции (гл) чувствовать (пер) гл. думать о чём-либо, ощущать, трогать
pimeja :: прил. чёрный, тёмный (сущ) темнота, тень (пер) гл. затемнять
pini :: сущ. конец, кончик (прил) законченный, прошлый (пер) гл. заканчивать, приближать, выключать
pipi :: сущ. насекомое, жук, паук
poka :: сущ. сторона, бок, край, бедро, почти (прил) соседний
poki :: сущ. контейнер, коробка, чашка
pona :: сущ. доброта, простота, позитивность (прил) хороший, простой, правильный (межд) хорошо! спасибо! OK! круто!  (пер) гл. улучшать, ремонтировать
sama :: прил. такой же, похожий, равный (prep) как (в сравнении)
seli :: сущ. огонь, тепло (прил) горячий, тёплый, приготовленный (о еде) (пер) гл. нагревать, готовить
selo :: сущ. поверхность, снаружи, кожа, раковина, форма
seme :: oth что? (вопросительное слово)
jan seme :: кто?
lon seme :: где?
tan seme :: почему?
kepeken nasin seme :: как? каким образом?
sewi :: сущ. верх, над, на (прил) верхний, возвышенный, религиозный, официальный
sijelo :: сущ. тело, физическое состояние
sike :: сущ. круг, колесо, кольцо, шар, мяч (прил) круглый, периодический (пер) гл. кружить
sin :: прил. новый, свежий, другой, ещё (пер) гл. обновить, освежить
sina :: сущ. ты (прил) твой
sinpin :: сущ. перед, грудь, торс, лицо, стена
sitelen :: сущ. изображение, картинка (пер) гл. рисовать, писать
sona :: сущ. знание, мудрость, понимание (пер) гл. знать, понимать
kama sona учиться
soweli :: сущ. животное, наземное млекопитающее
suli :: прил. большой, высокий, длинный, взрослый, важный (пер) гл. увеличивать, удлиннять (сущ) размер
suno :: сущ. солнце, свет
supa :: сущ. горизонтальная поверхность, мебель, стол, стул, колонна, этаж
suwi :: сущ. конфетка, лакомство (прил) сладкий, изящный (пер) гл. услащать
tan :: prep из, с помощью, благодаря, из-за, впоследствии, после (сущ) источник, причина
taso :: прил. единственный, исключительный; союз но, однако
tawa :: prep в, для, по направлению к (указывает на цель действия), до гл. идти, гулять, путешествовать, двигаться, покидать (сущ) передвижение, транспортировка (прил) передвижной, мобильный (пер) гл. двигать, перемещать
telo :: сущ. вода, жидкость, сок (пер) гл. мыть
tenpo :: сущ. время, период, момент, длительность, ситуация
toki :: сущ. язык, разговор, речь, коммуникация (прил) говорящий, вербальный (пер) гл. сказать (гл) общаться, болтать ; межд. привет! здравствуй!
tomo :: сущ. помещение, пространство, дом, комната, здание, конструкция (прил) городской, домашний
tu :: прил. двойной (сущ) два, пара (пер) гл. разделять, отделять
unpa :: сущ. пол, сексуальность (прил) эротический, половой (пер) гл. заниматься сексом
uta :: сущ. рот (прил) устный, произносимый вслух, оральный
utala :: сущ. конфликт, соревнование, схватка, бой, война, атака, спор, оскорбление, насилие (пер) гл. ударть, атаковать, соперничать
walo :: прил. белый, светлый (сущ) белая вещь, белизна, чистота
wan :: прил. один (сущ) единица, элемент, часть, частица, кусок (пер) гл. объединить
waso :: сущ. птица, животное с крыльями
wawa :: сущ. сила, энергия (прил) мощный, интенсивный, уверенный, сильный, энергичный (пер) гл. усиливать, укреплять, возбуждать
weka :: прил. далекий, отсутствующий, пропавший (сущ) отсутствие (пер) гл. выбросить, убрать, освободиться
wile :: пер. гл. хотеть, желать, сделать в будущем; сущ. желание, нужда, воля; прил. необходимый
